
Программа WMIC устарела.

[глобальные параметры] <команда>

Имеются следующие глобальные параметры:
/NAMESPACE           Путь к пространству имен, с которым оперирует псевдоним.
/ROLE                Путь к роли, содержащей определения псевдонимов.
/NODE                Серверы, с которыми будет работать псевдоним.
/IMPLEVEL            Уровень олицетворения для клиента
/AUTHLEVEL           Уровень проверки подлинности для клиента.
/LOCALE              Код языка, который должен использовать клиент.
/PRIVILEGES          Включает или выключает все привилегии.
/TRACE               Выводит отладочные данных в stderr.
/RECORD              Записывает все вводимые команды и их выходные данные.
/INTERACTIVE         Устанавливает или переустанавливает интерактивный режим.
/FAILFAST            Устанавливает или переустанавливает режим FailFast.
/USER                Имя пользователя для сеанса.
/PASSWORD            Пароль для входа в сеанс.
/OUTPUT              Задает режим перенаправления выходных данных.
/APPEND              Задает режим перенаправления выходных данных.
/AGGREGATE           Устанавливает или переустанавливает режим совместного вывода.
/AUTHORITY           Задает <тип_полномочий> для подключения.
/?[:<BRIEF|FULL>]    Сведения об использовании.

Для получения дополнительных сведений о конкретном глобальном параметре введите: <имя_параметра> /?


Для текущей роли доступны следующие псевдонимы:
ALIAS                    - Доступ к псевдонимам, доступным на локальном компьютере
BASEBOARD                - Управление системной платой.
BIOS                     - Управление BIOS.
BOOTCONFIG               - Управление конфигурацией загрузки.
CDROM                    - Управление устройствами чтения компакт-дисков.
COMPUTERSYSTEM           - Управление компьютером.
CPU                      - Управление ЦП.
CSPRODUCT                - Сведения о системе из SMBIOS.
DATAFILE                 - Управление файлами данных.
DCOMAPP                  - Управление приложениями DCOM.
DESKTOP                  - Управление рабочим столом.
DESKTOPMONITOR           - Управление системой мониторинга рабочего стола.
DEVICEMEMORYADDRESS      - Управление адресами памяти устройства.
DISKDRIVE                - Управление физическими дисками.
DISKQUOTA                - Использование дискового пространства для томов NTFS.
DMACHANNEL               - Управление каналами прямого доступа к памяти (DMA).
ENVIRONMENT              - Управление настройками системной среды.
FSDIR                    - Управление оглавлением файловой системы.
GROUP                    - Управление учетными записями групп.
IDECONTROLLER            - Управление IDE-контроллерами.
IRQ                      - Управление линиями запросов прерывания.
JOB                      - Доступ к заданиям, запланированным с помощью службы расписания.
LOADORDER                - Управление системными службами, задающими зависимости при выполнении.
LOGICALDISK              - Управление локальными запоминающими устройствами.
LOGON                    - Сеансы входа в систему.
MEMCACHE                 - Управление кэш-памятью.
MEMORYCHIP               - Информация о микросхемах памяти.
MEMPHYSICAL              - Управление физической памятью компьютерной системы.
NETCLIENT                - Управление сетевыми клиентами.
NETLOGIN                 - Управление данными входа в систему конкретных пользователей.
NETPROTOCOL              - Управление протоколами (и их сетевыми характеристиками).
NETUSE                   - Управление активными сетевыми соединениями.
NIC                      - Управление адаптерами сетевого интерфейса.
NICCONFIG                - Управление сетевыми адаптерами.
NTDOMAIN                 - Управление доменами NT.
NTEVENT                  - Записи в журнале событий NT.
NTEVENTLOG               - Управление файлом журнала событий NT.
ONBOARDDEVICE            - Управление основными встроенными адаптерами на системной плате.
OS                       - Управление установленными операционными системами.
PAGEFILE                 - Управления файлом подкачки виртуальной памяти.
PAGEFILESET              - Управление параметрами файла подкачки.
PARTITION                - Управление областями с разделами физического диска.
PORT                     - Управление портами ввода-вывода.
PORTCONNECTOR            - Управление физическими портами подключения.
PRINTER                  - Управление печатающими устройствами.
PRINTERCONFIG            - Управление конфигурацией печатающих устройств.
PRINTJOB                 - Управление заданиями печати.
PROCESS                  - Управление процессами.
PRODUCT                  - Управление задачами пакета установки.
QFE                      - Исправление QFE.
QUOTASETTING             - Настройка данных о дисковых квотах для тома.
RDACCOUNT                - Управление разрешениями для подключений к удаленному рабочему столу.
RDNIC                    - Управление подключением к удаленному рабочему столу на определенном сетевом адаптере.
RDPERMISSIONS            - Разрешения для определенного подключения к удаленному рабочему столу.
RDTOGGLE                 - Удаленное включение и отключение прослушивателя для удаленного рабочего стола.
RECOVEROS                - Данные, которые будут собраны из памяти при сбое операционной системы.
REGISTRY                 - Управление системным реестром компьютера.
SCSICONTROLLER           - Управление SCSI-контроллерами.
SERVER                   - Управление сведениями о сервере.
SERVICE                  - Управление служебными приложениями.
SHADOWCOPY               - Управление теневыми копиями.
SHADOWSTORAGE            - Управление областью хранения теневых копий.
SHARE                    - Управление общими ресурсами.
SOFTWAREELEMENT          - Управление установленными в системе компонентами программного продукта.
SOFTWAREFEATURE          - Управление подмножествами программных продуктов SoftwareElement.
SOUNDDEV                 - Управление звуковым устройством.
STARTUP                  - Управление командами, запускающимися автоматически при входе пользователей в систему.
SYSACCOUNT               - Управление системной учетной записью.
SYSDRIVER                - Управление системным драйвером базовой службы.
SYSTEMENCLOSURE          - Управление физическим системным корпусом.
SYSTEMSLOT               - Управление точками физических соединений, включая порты, гнезда и периферийные устройства, а также специальными точками соединения.
TAPEDRIVE                - Управление ленточными накопителями.
TEMPERATURE              - Управление датчиком температуры (электронным термометром).
TIMEZONE                 - Управление данными о часовых поясах.
UPS                      - Управление источниками бесперебойного питания (ИБП).
USERACCOUNT              - Управление учетными записями пользователей.
VOLTAGE                  - Управление данными датчика напряжения (электронного вольтметра).
VOLUME                   - Управление локальными томами хранилища.
VOLUMEQUOTASETTING       - Сопоставление дисковых квот конкретному тому.
VOLUMEUSERQUOTA          - Управление квотами для индивидуальных томов хранилищ.
WMISET                   - Управление параметрами работы службы WMI.

Для получения дополнительных сведений о конкретном псевдониме введите: <псевдоним> /?

CLASS     - переходит к полной схеме WMI.
PATH      - переходит к полным путям к объектам WMI.
CONTEXT   - выводит состояние всех глобальных параметров.
QUIT/EXIT - выполняет выход из программы.

Для получения дополнительных сведений о командах CLASS/PATH/CONTEXT введите: (CLASS | PATH | CONTEXT) /?